[TabTraducao]
NovoValor=Forneça o novo valor do pagamento
Embosso=Forneça os 4 dígitos finais do cartão
CodigoSeguranca=Código de Segurança do cartão (0: inexistente, 1: ilegível)
CodigoSegurancaObrigatorio=Código de Segurança do cartão
SaqueVisanet=Forneça o valor do Compra e Saque
ValorSaque=Forneça o valor do Saque
ProvedorConsultaCheque=Tipo da Consulta
ProvedorTelechequeGarantido=Telecheque Garantido
ProvedorInfoCardGarantido=INFOCARD CHEQUE GARANTIA
GarantiaChequeBancoMercantil=Garantia cheque Banco Mercantil
DataCheque=Forneça a data do cheque (DDMMAAAA)
DataNascimento=Forneça a data de nascimento (DDMMAAAA)
SolicitaEmitente=Forneça o nome do emitente do cheque
ValorCheque=Forneça o valor do cheque
DataAberturaConta=Forneça a data de abertura da conta (MMAAAA)
DadosCheque=Entre com os dados do Cheque
TipoDocumentoCheque=Tipo do documento (0: CPF, 1: CNPJ)
TipoDocumentoDeposito=Tipo do documento (0: CPF, 1: CNPJ, 2: ND)
CpfCgc=Forneça o número do documento
TipoDocumentoAdicional=Tipo do documento adicional (0: CPF, 1: CNPJ)
CpfCgcAdicional=Forneça o número do documento adicional
DDDTelefone=Forneça o DDD do telefone
Telefone=Forneça o telefone
TelefoneContato=Telefone para contato
TipoCartao=Selecione o tipo do cartão
FormaPagamento=Selecione a forma de pagamento
FormaPagamentoEstorno=Selecione como o documento foi pago
Cartão=Cartão
DocumentoCancelamento=Forneça o número do documento a ser cancelado
ValorCancelamento=Valor cancelam
DocumentoCapturaPreAutorizacao=Forneça o número do documento a ser confirmado
DocumentoAjuste=Forneça o número do documento  a ter o valor ajustado
TipoCancelamento=Selecione o tipo de cancelamento
SelecioneOpcaoGerencial=Selecione a opção desejada
DataValidadeCartao=Forneça a data de vencimento do cartão (MMAA)
TipoCartaoCredito=Selecione o tipo do Cartão de Crédito
TipoCartaoDebito=Selecione o tipo do Cartão de Débito
TipoPagamentoCartaoDebito=Selecione a forma de pagamento
TipoPagamentoCartaoCredito=Selecione a forma de pagamento
NumeroParcelas=Forneça o número de parcelas
NumeroCartao=Forneça o número do cartão
DataPreDatado=Forneça a data do Pré-datado (DDMMAAAA)
TipoGarantia=Pré-datado com (1) ou sem (2) garantia
ValorEntrada=Forneça o valor da entrada
TipoCrediario=Tipo do crediário (0: normal, 1: cheque)
DataPrimeiraParcela=Forneça a data da primeira parcela (DDMMAAAA)
ValorPreAutorizacao=Forneça o valor da Pré-autorização
TipoDebitoParcelado=Selecione o tipo de parcelamento
CodigoAutorizacao=Forneça o código de autorização
DataTransacao=Data da transação (DDMMAAAA)
DataTransacaoDDMM=Data da transação (ddmm)
ValorConsultaCDC=Forneça o valor a ser consultado
Supervisor=Forneça o código do supervisor
PrimeiraParcelaVista=Primeira Parcela à Vista?
IntervaloEntreParcelas=Intervalo entre parcelas
MesFechado=Mês fechado?
TipoReimpressao=Tipo do comprovante a ser reimpresso
DocumentoReimpresso=Forneça o documento a ser reimpresso
CodigoDoItem=Código do Item
CiclosAPular=Número de ciclos a pular
CodigoPlano=Código do Plano de Pagamento
NumeroCpf=Forneça o número do CPF
NsuSiTefEstorno=Nsu SiTef a ser estornado
DataEmissao=Forneça a data de emissão do cartão (MMAAAA)
FormaPagamentoCentralCard=Forma de pagamento (1:Dinheiro, 2:Cheque, 3:Outra)
NumeroDaParcela=Número da parcela
Provimilhas=Valor ProviMilhas
TipoDocProvincial=Tipo do Documento
ComSemProvimilhas=Utilizara Provimilhas
ErroProvimilhas=Provimilhas inválido
SaldoAPagar=Saldo a pagar
PerguntaFechamento=1: Confirma, 2: Cancela, 3: Desiste
Endereco=Endereço da fatura do cartão
EnderecoNumero=Número
EnderecoAndar=Andar
EnderecoConjunto=Apto/Conjunto
EnderecoBloco=Bloco
EnderecoCep=Cep
EnderecoBairro=Bairro
Cpf=Cpf
ConsultaSaqueRotativo=Consulta Saque Rotativo
ConsultaSaqueParcelado=Consulta Saque Parcelado
SaqueFininvest=Forneça o valor a ser Sacado
NumeroCheque=Número do cheque
SolicitaRG=Forneça o RG do cliente
SolicitaLocalizador=Forneça o localizador
CartaoCreditoCentralizado=Cartão de Crédito Centralizado
SolicitaTipoConta=Forneça o tipo de conta: 0: Corrente, 1: Poupança, 2: Salário
SolicitaTipoContaProvincial=Entre con el tipo de cuenta: 1: Corriente,  2: Ahorro,  3 a 20: Otros
SolicitaTipoContaBOD=Forneça o tipo de conta: 0: Corriente,  1: Ahorro,  2: FAL
SolicitaTipoContaConsorcio=Forneça o tipo de conta: 0: Default account,  1: Savings account,  2: Checking account, 4: FAL
ConfirmacaoPinPad=Solicite confirmação do cliente no PinPad
TemReceitaMedica=Possui receita médica?
CRM=Forneça o CRM do médico
UF=Forneça a UF do médico
DescricaoProduto=Descrição produto
CodigoProduto=Código produto
QuantidadeProduto=Quantidade produto
ValorProduto=Valor unitário produto
Descricao=Descrição
TipoDevolucao=Selecione o tipo da devolução
NumeroContrato=Número Contrato
GrupoProduto=Grupo do produto: 0: Medicamento; 1: Perfumaria
GrupoProdutoInvalido=Grupo do produto inválido
NumeroAutorizacao=Número Autorização
TipoDocumentoElegibilidade=Tipo de documento
PalavraCRM=CRM
PalavraCRO=CRO
SemReceitaMedica=Sem receita médica
TipoPrescritor=Tipo do prescritor
IntervaloParcelasInvalido=Intervalo entre as parcelas inválido
DataClienteDesde=Cliente desde (DDMMAAAA)
DemonstrativoPrazos=Demonstrativo de prazos : 0: Não; 1: Sim
CancelamentoTotalParcial=Cancelamento Total/Parcial : 0: Parcial; 1: Total
InsiraScanner=Insira o cheque no scanner
ProvedorConsultaChequeGenerica=Consulta Cheque Genérica
ProvedorConsultaChequePapelTecban=Consulta Cheque Papel Tecban
ProvedorGarantiaChequePapelTecban=Garantia Cheque Papel Tecban
ProvedorConsultaChequePapelSPCBrasil=Consulta Cheque Papel SPC Brasil
ProvedorGarantiaChequePapelSPCBrasil=Garantia Cheque Papel SPC Brasil
ProvedorGarantiaChequePapelCDLRio=Garantia Cheque Papel CDL Rio
ProvedorGarantiaChequePapelCDLPoa=CONSULTA CHEQUE CDL POA
ConsultaGarantiaChequeCDLPoa=CONSULTA GARANTIA CHEQUES CDL POA
CancelamentoGarantiaChequeCDLPoa=CANCELAMENTO GARANTIA CHEQUES CDL POA
ProvedorTelechequeGarantidoTecban=Telecheque Garantido Tecban
CartaoDebito=Cartão de Débito
CartaoPrePago=Cartão Pré-Pago
CartaoRefeicaoEletronico=Refeição Eletrônico
CartaoSmartNet=SmartNet
SmartNetInserirCartao=Insira o cartão na leitora SmartNet e siga suas instruções
SmartNetRemoverCartao=Retire o cartão da leitora SmartNet
SmartNetErroLeitora=Erro na leitora SmartNet
MenuCTF=Petrobras Premmia
OpcaoCTFCadastroConsumidor=Cadastro consumidor
OpcaoCTFAcumuloPontos=Acumulo de pontos
OpcaoCTFEstornoPontos=Estorno de pontos
OpcaoCTFResgatePontos=Resgate de pontos
CodigoAtendentePremmia=Código Premmia do atendente
MenuCTFLocal=Local do atendimento
OpcaoCTFLocal1=Pista
OpcaoCTFLocal2=BR Mania
OpcaoCTFLocal3=Lubrax +
CartaoCredito=Cartão de Crédito
Cheque=Cheque
VoucherPapel=Voucher Papel
CancelamentoDebito=Cancelamento de Cartão de Débito
CancelamentoCredito=Cancelamento de Cartão de Crédito
ReimpressaoNoComprovante=REIMPRESSAO
Reimpressao=Reimpressão de comprovante
Cancelamento=Cancelamento de transação
TesteComunicacao=Teste de comunicação
SoMagnetico=Magnético
NaoMagnetico=Digitado
NaoMagneticoCpf=Digitado via CPF
NaoMagneticoCodigoBarras=Leitura via código de barras
CreditoVista=À Vista
CreditoVistaComJuros=À Vista Com Juros
Diferida=Diferida
ProRataVista=Pro-rata à vista
ProRataParcelado=Pro-rata parcelado
ConsultaParcelas=Consulta parcelamento
ConsultaAVS=Consulta AVS
PreAutorizacao=Pré-autorização
CapturaPreAutorizacao=Confirmação de Pré-autorização
RotativoVista=Rotativo à vista
RotativoParcelado=Rotativo Parcelado
Crediario=Crediário
DebitoVista=À Vista
CompraSaque=Compra e Saque
DebitoPreDatado=Pré-Datado
DebitoParcelado=Parcelado
DebitoCDC=CDC
DebitoUmMinuto=Crédito Um Minuto
DebitoBancoSimParcelado=Banco SIM Parcelado
DebitoParcelasIguais=Parcelas Iguais
CancelamentoPreAutorizacaoCredito=Cancelamento de Pré-autorização
CancelamentoCapturaPreAutorizacaoCredito=Cancelamento de Confirmação de Pré-autorização
ConsultaCDC=Consulta parcelas CDC
ReimpressaoEspecifica=Especifica
ReimpressaoEspecificaVisanet=Cielo
ReimpressaoEspecificaRedecard=Redecard
ReimpressaoUltimoComprovante=Ultimo comprovante
RotativoAVistaFin=Rotativo à vista
RotativoPreDatadoFin=Rotativo pré-datado
ParceladoFin=Parcelado
ParceladoPreDatadoFin=Parcelado pré-datado
CancelamentoGarantiaCheque=Cancelamento Garantia de Cheque Tecban
CancelamentoGarantiaChequeSPCBrasil=Cancelamento Garantia de Cheque SPC Brasil
CartaoCisa=Cisa
SaldoExtratoCisa=Consulta Saldo/Extrato Cisa
OpcaoConsultaSaldoCisa=Saldo
OpcaoConsultaExtratoCisa=Extrato
ConsultaTotaisCompra=Consulta Totais
ConsultaTotaisAPagarCompra=Consulta Totais a Pagar
CartaoInfoCard=InfoCard
DataEmissaoCartaoInfoCard=Forneça a data de emissão do cartão (MMAAAA)
CancelamentoInfoCard=Cancelamento de Cartão InfoCard
PagamentoInfoCard=Pagamento Cartão InfoCard
CancelamentoPagamentoInfoCard=Cancelamento de Pagamento Cartão InfoCard
CancelamentoChequeGarantiaInfoCard=Cancelamento de Cheque Garantia InfoCard
TipoCartaoConsultaInfoCard=Tipo Cartão Consulta Dados Cadastrais InfoCard
CartaoBeneficio=Cartão Beneficio
CancelamentoCartaoBeneficio=Cancelamento Cartão Beneficio
ProvedorBeneficio=Provedor Beneficio
ProvedorWappa=Wappa
TipoBeneficio=Tipo do Beneficio
Refeição=Refeição
Alimentacao=Alimentacao
NumeroCartaoWappa=Forneça o DDD e Celular no formato ddtttttttt
CartaoQualicard=Cartão Qualicard
CartaoCombustivel=Cartão Combustível
SaldoCombustivel=Consulta Saldo Combustível
FalhaTrocaSenhaNPTC=Falha na troca de senha
SucessoTrocaSenhaNPTC=Troca de senha efetuada com sucesso
CartaoNPTC=Cartão Ticket Car Smart
MenuNPTC=Cartão Ticket Car Smart
CasasDecimais=Casas decimais de preços unitários
TamCodProduto=Tamanho do código de produto
ServicosIncompativeis=Não existem serviços compatíveis
Horimetro=Horímetro do veículo
HorimetroInvalido=Horímetro inválido
CodigoVeiculo=Código do veículo ou equipamento
ExcedeuTanque=Excedeu tanque
PlacaInvalida=Placa inválida
CIUInvalido=CIU inválido
CIUVencido=CIU vencido
KMInvalidoContinua=Valor inválido do hodometro. Continua?
HRInvalidoContinua=Valor inválido do horimetro. Continua?
PPPasseCartaoCIU=    Passe o    \r   cartao CIU
DIPasseCartaoCIU=Passe o cartão CIU
PPDigiteSenhaMotorista= Digite a senha   do motorista
DIDigiteSenhaMotorista=Digite a senha do motorista
ContinuaCadastro=Incluir mais produtos?
CancelamentoNPTC=Cancelamento de Cartão Ticket Car Smart
ExcedeuQtdMercadorias=Excedeu quantidade mercadorias permitidas
ListaMercadoriasAusente=Mercadorias não informadas
ProcessandoOffline=Processando transações offline do cartão
FalhaAtualizacaoNPTC=Falha na atualização do cartão
SemAtualizacaoNPTC=Não ha atualização para este cartão
SucessoAtualizacaoNPTC=Cartão atualizado com sucesso
PalCasasDecimais=casas decimais
ConsultaSaldoNPTC=Consulta saldo Ticket Car Smart
ConsultaProdutosHostNPTC=Consulta produtos Ticket
ConsultaProdutosPDVNPTC=Consulta produtos PDV
CadastroProdutosNPTC=Cadastro produtos e preços
AtualizaCartaoNPTC=Atualiza cartão Ticket Car Smart
BoletoVendaNPTC=Imprimir boleto de transação manual
Produtos=Produtos
ColetaRede=Forneça o código da Rede Autorizadora
VendaValorDiferenteNaoPermitida=Venda valor diferente não permitida
NenhumProdutoInformado=Nenhum produto informado
PagamentoCentralCard=Pagamento Cartão Central Card
CancelamentoPagamentoCentralCard=Cancelamento de Pagamento Cartão Central Card
PagamentoBancoIbi=Pagamento de Conta Banco Ibi
CancelamentoPagamentoBancoIbi=Cancelamento de Pagamento Banco Ibi
TipoEntradaDadosPagamentoBancoIbi=Tipo de entrada
ConsultaSaqueBancoIbi=Consulta Saque e Saque Banco Ibi
OpcaoConsultaSaqueBancoIbi=Consulta Saque
OpcaoSaqueBancoIbi=Saque
OpcaoConsultaSaqueComSaqueBancoIbi=Consulta Saque com Saque
TituloSaqueBancoIbi=Saque Banco Ibi
CancelamentoSaqueBancoIbi=Cancelamento Saque Banco Ibi
ErroPlanoNaoDisponivelBancoIbi=Plano não disponível
PagamentoPortalCard=Pagamento Cartão PortalCard
CancelamentoPagamentoPortalCard=Cancelamento de Pagamento Cartão PortalCard
PagamentoParati=Pagamento Cartão Parati
PagamentoEdiguay=Pagamento Cartão Ediguay
PagamentoOrbitall=Pagamento Cartão Orbitall
CancelamentoPagamentoOrbitall=Cancelamento de pagamento Cartão Orbitall
PagamentoCooperCred=Pagamento Cartão CooperCred
PagamentoDDTotal=Pagamento Cartão DDTotal
TipoDocumentoDDTotal=Tipo do documento
CancelamentoPagamentoDDTotal=Cancelamento de Pagamento Cartão DDTotal
PagamentoValidata=Pagamento Cartão Validata
ConsultaPagamentoValidata=Consulta de Pagamento Cartão Validata
CancelamentoPagamentoBancoPanamericano=Cancelamento de Pagamento de Conta Banco Panamericano
PagamentoBancoPanamericano=Pagamento de Conta Banco Panamericano
CancelamentoPagamentoSigaCred=Cancelamento de Pagamento Cartão SigaCred
PagamentoSigaCred=Pagamento Cartão SigaCred
TipoPagamentoCartaoSigaCred=Tipo Pagamento SigaCred
PagamentoFatura=Pagamento de Fatura
PagamentoConvenio=Pagamento de Convênio
NumeroFatura=Número da Fatura
NumeroConvenio=Número do Convênio
CancelamentoPagamentoCooperCred=Cancelamento de pagamento Cartão CooperCred
VendaMilhagemCooperCred=Venda Milhagem CooperCred
CancelamentoVendaMilhagemCooperCred=Cancelamento Venda Milhagem CooperCred
CargaPrePago=Carga de Pré-Pago
CancelamentoCargaPrePago=Cancelamento de Carga de Pré-Pago
CodigoVoucherPapel=Código Voucher
CancelamentoPagamentoEdiguay=Cancelamento de Pagamento Cartão Ediguay
PagamentoSoftway=Pagamento Cartão Softway
SaldoSoftway=Consulta Saldo Softway
SaqueSoftway=Saque Softway
TipoConsultaSaldo=Tipo Consulta Saldo
SaldoDebito=Consulta Saldo Débito
SaldoCredito=Consulta Saldo Crédito
SaldoPrePago=Consulta Saldo Pré-Pago
SaqueCredito=Saque Crédito
SaqueDebito=Saque Débito
Quitacao=Quitação Frete Eletrônico POLICARD
FreteEletronico=Frete Eletrônico
QtdeChegada=Quantidade de Chegada
ExtratoCredito=Extrato Crédito
SaldoConvenioCredito=Consulta Saldo Convênio
LiberacaoCartaoCredito=Consulta Liberação Cartão Crédito
ConsultaUltFaturaCredito=Consulta Ultima Fatura Cartão Crédito
ConsultasCartaoCredito=Consultas Cartão Crédito
TipoConsultaCredito=Tipo Consulta Cartão Crédito
CancelamentoSaqueCredito=Cancelamento Saque Crédito
CancelamentoSaqueSoftway=Cancelamento Saque Softway
AlteraSenhaCredito=Alteração de Senha Crédito
LiberaCartaoCredito=Liberação de Cartão Crédito
TrocoSurpresa=Troco Surpresa
VendaValeGas=Venda ValeGas
CancelamentoValeGas=Cancelamento ValeGas
RedeValeGas=Selecione a rede ValeGas
ValeGasUltragaz=Ultragaz
ValeGasGetnet=GetNet
MenuOperadoraValegas=Selecione a operadora ValeGas
MenuProdutoValegas=Selecione o produto ValeGas
NumeroValeGas=Número do ValeGas
CancelamentoPagamentoSoftway=Cancelamento de Pagamento Cartão Softway
DocProvincial=Doc. Provincial
DocNaoProvincial=Doc. Não Provincial
ComProvimilhas=Com Provimilhas
SemProvimilhas=Sem Provimilhas
CartaoFininvest=Cartão Private Label
OpcaoConsultaSaqueFininvest=Consulta saque
OpcaoSaqueFininvest=Saque
SaqueRotativo=Rotativo
SaqueParcelado=Parcelado
CancelamentoChequeProvincial=Cancelamento de cheque
DevolucaoPagamento=Devolução
DevolucaoDebito=Devolução de Cartão de Débito
DevolucaoCredito=Devolução de Cartão de Crédito
ConsultaEstadoLote=Consulta estado do lote atual
FechamentoLoteProvincial=Fecha o lote atual - Provincial
FechamentoLoteBancoMercantil=Fechamento de lote - Banco Mercantil
FechamentoLoteAtualBancoMercantil=Fecha o lote atual
FechamentoLoteEspecificoBancoMercantil=Fecha lote especifico
FechamentoLoteBOD=Fechamento de lote - BOD
FechamentoLoteBODDebito=Fechamento de lote - BOD DEBITO
FechamentoLoteConsorcioVenezuela=Fechamento de lote - Consorcio Venezuela
ConsultaCheque=Consulta Cheque
ConsultaChequeProvincial=Consulta Cheque - Provincial
ConsultaChequeBOD=Consulta Cheque - BOD
ConsultaChequeConsorcioVenezuela=Consulta Cheque - Consorcio Venezuela
AjusteCompra=Ajuste de compra
AjusteCompraCredito=Ajuste de compra crédito
AjusteCompraDebito=Ajuste de compra débito
TrocoPremiado=Troco Premiado
CancelamentoTrocoPremiado=Cancelamento Troco Premiado
MenuSPTrans=Consulta e Recarga SPTrans
MenuSPTransProduto=Escolha o produto
OpcaoSPTransConsultaSaldo=Saldo do cartão
OpcaoSPTransRecarga=Recarga
OpcaoSPTransRecargaDesvinculada=Recarga desvinculada
OpcaoSPTransConsultaProdutos=Produtos
SPTransValorRecarga=Forneça o valor da recarga
SPTransErroRecarga=Erro na recarga do cartão
SPTransInserirCartao=Insira o cartão no terminal Bilhete Único
SPTransRemoverCartao=Retire o cartão do terminal Bilhete Único
SPTransErroSemLeitora=Leitora não instalada ou não configurada
SPTransErroCartaoInvalido=Cartão inválido
SimulacaoSPTrans=Ambiente Simulado SPTrans, a recarga não será efetuada
OpcaoSPTransPagamento=Pagamento da Recarga SPTrans
OutraFormaPgto=Outra forma
MenuRecargaCelular=Recarga de Celular
MenuCB=Correspondente Bancário
PagamentoConta=Pagamento de Conta
PagamentoContaBanrisul=Pagamento de Conta Banrisul
EstornoPagamentoConta=Estorno de Pagamento
EstornoPagamentoContaBanrisul=Estorno de Pagamento Banrisul
ReImpressaoPagamentoConta=Reimpressão de Pagamento
MenuAdministrativoCB=Administrativas
MenuAdministrativoCBBanrisul=Administrativas Banrisul
SaqueCBBanrisul=Saque Banrisul
PagamentoDinheiro=Dinheiro
CartaoMagnetico=Cartão Magnético
CartaoDigitado=Cartão Digitado
BoletoBancario=Boleto
Contrato=Contrato
PagamentoBeneficio=Pagamento Beneficio
EstornoPagamentoBeneficio=Estorno Pgto Beneficio
AberturaCaixaCB=Abertura do caixa
FechamentoCaixaCB=Fechamento do caixa
SangriaCaixaCB=Sangria do caixa
RepasseCB=Fechamento de Repasse
TipoCartaoBonus=Cartão Bônus
TipoCartaoPresente=Cartão Presente
CancelamentoCartaoPresente=Cancelamento de Cartão Presente
MenuOutros=Outros Cielo
ReimpressaoLojista=Via Lojista
ReimpressaoPortador=Via Portador
ReimpressaoTodas=Todos
CartaoPaggo=Celular (VAPPT)
CancelamentoCartaoPaggo=Cancelamento Celular (VAPPT)
TipoEntradaChequeInvalido=Tipo de entrada de cheque inválido
CartaoCondor=Cartão Condor
CartaoEletrozema=Cartão Eletrozema
ParceladoSimples=Parcelado
ParceladoCreditoCDC=Crédito CDC
PagamentoHotCard=Pagamento Cartão HotCard
CancelamentoHotCard=Cancelamento de Pagamento Cartão HotCard
NumSequencial=Número sequencial da transação
PagamentoClubCard=Pagamento Cartão ClubCard
CancelamentoPagamentoClubCard=Cancelamento de Pagamento Cartão ClubCard
SaqueClubCard=Saque ClubCard
PagamentoCredMais=Pagamento Cartão CredMais
CancelamentoPagamentoCredMais=Cancelamento de Pagamento Cartão CredMais
MenuOperadoraCelularMultipla=Concessionária
ValorRecargaCelular=Selecione o valor a ser carregado no celular
DDDNumeroCelular=Forneça o número do DDD (2 dígitos) e do Celular
DDDNumeroCelularRedig=Redigite o número do DDD (2 dígitos) e do Celular
CEPPdvCelular=Forneça o CEP da loja
RecargaCelularNaoAceita=Recarga não aceita
DDDNumeroCelularPinPad=Solicite digitação celular (ddtttttttt) no pinpad
DDDNumeroCelularRedigPinPad=Solicite redigitação celular (ddtttttttt) no pinpad
SemValoresRecarga=Sem valores recarga
CelularNaoConfere=Celular não confere
FornecaDigitoVerificador=Forneça o Dígito Verificador
FornecaDigitosVerificadores=Forneça os Dígitos Verificadores
DigitoVerificador=Dígito Verificador
DigitosVerificadores=Dígitos Verificadores
BonusDe=Bônus de
SaldoDe=Saldo de
SaldoComumDe=Saldo comum de
PalavraDigite=Digite
PalavraBonus=Bônus
PalavraCusto=Custo
PalavraValidade=Validade
PalavraDias=Dias
BonusSMS=Bônus em SMS
BonusPontos=Bônus em Pontos
ConfirmaRecarga=Confirma Recarga?
PalavraCelular=Celular
PalavraOperadora=Operadora
ConfirmaRecargaDe=Confirma recarga de
ConfirmaRecargaEm=Confirma recarga em
ConfirmaCelular=Confirma celular
ConfirmaTarifa=Confirma Tarifa
ConfirmaPagamentoDe=Confirma pgto. de
Correspondente=Corresp. Bancário - Selecione uma opção
Documento=Documento a ser pago
DataVencimentoDocumento=Data do Vencimento (DDMMAAAA)
ValorPagamento=Valor Total
ValorOriginal=Valor Original
ValorAcrescimo=Valor do Acréscimo
ValorAbatimento=Valor do Abatimento
DocumentoEstorno=Documento a ser estornado
DataVencimentoPagamento=Data do Pagamento (DDMMAAAA)
TipoEntradaDadosRecebimentoFininvest=Tipo de entrada
ValorBeneficio=Valor Beneficio
OperadorCB=Código do operador
SenhaOperadorCB=Senha do operador
OpcoesAdministrativasCB=Selecione uma transação
OperadorNaoCadastrado=Operador não cadastrado
SenhaOperadorNaoCorreta=Senha incorreta
DataNaoConfere=Data não confere
ValorDescInvalido=Valor desconto inv.
ConfValorDiferente=Confirma Valor Total Diferente
NecessarioSangria=É necessário fazer sangria
CaixaJaAberto=Caixa já aberto
ConfAberturaCaixa=Confirma abertura do caixa
CaixaNaoAberto=Caixa não aberto
ConfFechamentoCaixa=Confirma fechamento do caixa
ConfSangriaCaixa=Confirma sangria do caixa
ReentreValorOriginal=Reentre com o Valor Original
ReentreValorAbatimento=Reentre com o Valor do Abatimento
ReentreValorAcrescimo=Reentre com o Valor do Acréscimo
ReentreValorTotal=Reentre com o Valor Total
PalavraVencimento=Vencimento
PalavraConfirma=Confirma
ReentreDataVencimento=Reentre a Data de Vencimento (DDMMAAAA)
ValorBoleto=Valor do boleto
ConfirmaValorPagamento=Confirma o valor total do pagamento
FornecerNovoValor=Deseja fornecer um novo valor?
ExtratoCB=Extrato
SaldoCB=Saldo
SaqueCB=Saque
ValorSaqueCB=Valor Saque
DepositoCB=Depósito
DepositoIdentificadoCB=Depósito Identificado
DarfCB=DARF
GpsCB=GPS
TipoDarf=Tipo do DARF
DarfSimples=DARF Simples
DarfPreto=DARF Preto
TipoDocumento=Tipo do documento (0: CPF, 1: CNPJ)
PeriodoApuracao=Período de Apuração (DDMMAAAA)
ValorMulta=Valor Multa
ValorJuros=Valor Juros
ValorTotal=Valor Total
CodigoReceita=Código da Receita
ValorReceitaBruta=Receita Bruta
PercentualAplicado=Percentual Aplicado
ValorPrincipal=Valor Principal
NumeroReferencia=Número de Referencia
CodigoGps=Código GPS
CompetenciaGps=Competência GPS (MMAAAA)
IdentificadorContribuinte=Identificador do Contribuinte
ValorInss=Valor INSS
ValorOutrasEntidades=Valor Outras Entidades
RecargaBradesco=Recarga Celular Bradesco
RecargaHsbc=Recarga Celular Corban SE
TotalDinheiro=Valor total em dinheiro
DepositarCheque=Depositar cheque?
OutroCheque=Depositar outro cheque?
TipoConta=Selecione o tipo de conta
ContaCorrente=Corrente
TextoContaCorrente=Conta corrente
ContaPoupanca=Poupança
ContaBeneficio=Beneficio INSS
ContaSalario=Salário
ContaEmpresa=Empresa
ContaFuncionarioViajante=Funcionário Viajante
ContaInvestimento=Investimento
ContaPontos=Pontos
ContaMaximaFal=Maxima/Fal
TipoSaque=Selecione o tipo de saque
Magnetico=Magnético
ReciboRetirada=Recibo de Retirada
EstornoSaqueCB=Estorno de Saque
TipoEstornoSaqueCB=Selecione o tipo de estorno de saque
EstornoDepositoCB=Estorno de Depósito
EstornoDarfCB=Estorno DARF
EstornoGpsCB=Estorno GPS
TipoEstornoDepositoCB=Selecione o tipo de estorno de depósito
DepositoDinheiro=Dinheiro
DepositoCheque=Cheque
DepositoDinheiroCheque=Dinheiro e Cheque
QuantidadeCheques=Quantidade de cheques
NomeDepositante=Nome do depositante
DataInicial=Data Inicial (DDMMAAAA)
DataFinal=Data Final (DDMMAAAA)
Banco=Banco
Agencia=Agencia
DigitoAgencia=Dígito agência
Conta=Conta
DigitoConta=Dígito Conta
NomeFavorecido=Nome do favorecido
ConfirmaDadosFavorecido=Confirma os dados do favorecido?
TipoExtrato=Tipo de extrato
ExtratoPeriodo=Por período
ExtratoUltimosLancamentos=Últimos lançamentos
ExtratoUltimosDias=Últimos 5 dias
DesbloqueioCheques=Desbloqueio de cheques
SolicitaNumeroLote=Número do lote
SolicitaNumeroTerminal=Número Terminal
SolicitaDataLote=Data do lote (DDMM)
DeveColetarValorTroco=Deve coletar valor troco
IdNome=DP05 Id Nome
IdNumerica=DP06 Id Numérica
CartaoPgto=Cartão Pgto
PgtoFatura=Pgto Fatura
SemConexaoSiTef=Sem conexão SiTef
ServicoIndisponivel=Serviço não disponível
Moeda=R$
TransacaoInvalida=Transação Inválida
DadosInvalidos=Dados Inválidos
PasseCartaoLeitora=Insira ou passe o cartão na leitora
ConfirmaValor=Confirme Valor
SolicitaSenha=Solicite a digitação da senha
SolicitaSenhaVisorCliente=Digite a senha
SolicitaSenhaAtual=Solicite a digitação da senha atual
SolicitaSenhaAtualVisorCliente=Digite a senha atual
SolicitaSenhaNova=Solicite a digitação da nova senha
SolicitaSenhaNovaVisorCliente=Digite a nova senha
DataValidadeInvalida=Data de Vencimento Inválida
TrnNaohabilitada=Transação não habilitada
CodigoSegurancaInvalido=Código Segurança Inválido
CodigoTipoContaInvalido=Tipo de Conta Inválido
CodigoTipoDocumentoInvalido=Tipo Documento Inválido
Aguarde=Aguarde, em processamento...
TesteComunicacaoSiTef=Confirma o teste de comunicação com o SiTef em
SitefAtivo=SiTef Ativo
CartaoNaoAceito=Cartão não aceito
TrnNaoAprovada=Transação não aprovada
DigiteSenha=Digite a senha
PagamentoCBNaoAceito=Pagamento não aceito
EstornoCBNaoAceito=Estorno não aceito
SemComprovante=Sem comprovante
ConfirmaReImpressao=Conf.reimpressão
RetireCartao=Retire o cartão da leitora
ViaReimpressao=Via a ser reimpressa
ErroChip=Erro na leitura do chip. Passe o cartão na leitora
ErroCartao=Erro na leitura do cartão. Passe ou insira o cartão na leitora
CancCliente=Canc. Cliente
ErroLeitura=Erro Leitura
ErroPin=Erro Conecte Pin
ErroDLL=Erro acesso DLL
ErroAPPCisa=Erro /APP cartão Cisa
ErroAPCCisa=Erro /APC cartão Cisa
ErroATCCisa=Erro /ATC cartão Cisa
ErroACCCisa=Erro /ACC cartão Cisa
ErroGRCCisa=Erro /GRC cartão Cisa
ErroCSECisa=Erro /CSE cartão Cisa
ErroLibPinpad=lib pinpad não encontrada
PPAtualizandoTabelas=  ATUALIZANDO\r    TABELAS
DIAtualizandoTabelas=ATUALIZANDO TABELAS
AtualizandoReg=Atualizando Reg.
AguardandoReg=Aguardando Reg.
ErroOffline=OFFLINE NAO IMPLEMENTADO
ErroTOSenha=EXCEDIDO TEMPO DIGITACAO SENHA
Processando=Processando...
PPNaoAutorizadaCartao= TRANSACAO NAO\rAUT. PELO CARTAO
DINaoAutorizadaCartao=Transação não autorizada pelo cartão
ErroChipNaoAut=ERRO CHIP, NAO AUT
VerificacaoSaldo=Solicite Verificação do Saldo
PPTransNaoAceita=   TRANSACAO       NAO ACEITA
DITransNaoAceita=Transação não aceita, Retire o Cartão
PPTransAceita=   TRANSACAO         ACEITA
DIErroPinpad=Erro Pinpad
PPOperacaoCancelada=    OPERACAO\r    CANCELADA
DIOperacaoCancelada=Operação Cancelada
PPCartaoErroLeitura=ERRO DE LEITURA\rTENTE NOVAMENTE
DICartaoErroLeitura=Erro de Leitura. Tentar novamente?
PPCartaoRemovido=     CARTAO\r    REMOVIDO
DICartaoRemovido=Cartão Removido
DIPinpadOcupado=Pinpad Ocupado
DIErroSAM=Probl.Mod.SAM - Ligue Help Desk
PPCartaoErroMalInserido=CARTAO COM ERRO\rOU MAL INSERIDO
DICartaoErroMalInserido=Cartão com Erro ou Mal Inserido
PPCartaoInvalido=     CARTAO\r    INVALIDO
DICartaoInvalido=Cartão Inválido
PPCartaoInvalidado=     CARTAO\r   INVALIDADO
DICartaoInvalidado=Cartão Invalidado
PPCartaoBloqueado=     CARTAO\r   BLOQUEADO
DICartaoBloqueado=Cartão Bloqueado
PPCartaoVencido=     CARTAO\r    VENCIDO
DICartaoVencido=Cartão Vencido
PPModoInvalido= MODO INVALIDO\r PASSE O CARTAO
DIModoInvalido=Modo Inválido. Retire e Passe o Cartão
PPCartaoNaoAceito=   CARTAO NAO\r     ACEITO
DICartaoNaoAceito=Cartão não Aceito. Retire o Cartão
PPSaldoInsuficiente=     SALDO\r  INSUFICIENTE
DISaldoInsuficiente=Saldo Insuficiente no Moedeiro
PPLimiteExcedido= EXCEDE LIMITE\r POR TRANSACAO
DILimiteExcedido=Excede Limite por Transação
PPErroCartaoNaoEfetivo=   CARTAO NAO\r     EFETIVO
DIErroCartaoNaoEfetivo=Cartão não Efetivo
PPMoedaInvalida= CARTAO POSSUI\r MOEDA INVALIDA
DIMoedaInvalida=Cartão Possui Moeda Inválida
DIErroProblemaPAN=Cartão com Problema
PPErroProblemaPAN=     CARTAO\r  COM PROBLEMA
DIErroCriptografia=Erro na criptografia PinPad
DIPPNaoValidado=Erro na validação do PinPad
ValoresDiferentes=Valor não confere
ValorInvalido=Valor inválido
PPPasseCartao= PASSE O CARTAO
DIPasseCartao=Passe o cartão
ErroLeituraBonus=Erro na leitura do cartão
PasseCartaoVale=Passe o vale na leitora
ErroLeituraVale=Erro na leitura do vale
ValeJaUtilizado=Vale já utilizado
CanceladoCliente=Cancelado cliente
NumParcelasInvalido=Número de Parcelas Inválido
ExcedeParcelas=Excede Parcelas
ExcedeTaxa=Excede Taxa
ExcedePrazo=Excede Prazo
DataInvalida=Data Inválida
OperacaoNaoPermitida=Operação não permitida
ExcedeValorTotal=Excede valor total pagamento
AbaixoValorTotal=Inferior ao valor total do pagamento
GarantiaInvalida=Garantia Inválida
AguardeAtualizacao=Aguarde atualização cartão
SaldoInsuficiente=Saldo insuficiente
FaltaMemoria=Falta memória
ChipObrigatorio=Uso de chip obrigatório
ChipInsiraCartao=Cartão com chip. Insira o cartão
ChipNaoAceito=Cartão com CHIP não aceito. Passe o cartão
FuncChipInativa=FUNC.CHIP INATIV PASSE O CARTAO
DigitaCartao=Digita Cartão?
FinalizadoCliente=Finalizado pelo Cliente
TempoExcedido=Tempo excedido
ErroComunicPP=Erro Comunic. PinPad
FaltaMasterKeyPin=Falta masterkey pin
LibppemvInexistente=libppemv inexistente
ErroPortaPP=Erro Porta PinPad
PalavraErro=Erro
PalavraPinPad=PinPad
PalavraSenha=Senha
PalavraSaldo=Saldo
PalavraValor=Valor
Chip=Chip:
SoliciteSenha=Solicite Senha
FaltaDefinirTipoPP=Falta definir tipo do PinPad
NaoEncontrouDll=Não encontrou a dll 
NaoEncontrouRotinaNaDll=Não encontrou rotina na dll
PPRetireCartao=RETIRE O CARTAO
ConfirmaCancelamento=Confirma Cancelamento?
CartaoVoucherAVista=Cartão Voucher à Vista
CartaoCreditoAVista=Cartão de Crédito à Vista
CartaoCreditoAVistaComJuros=Cartão de Crédito à Vista Com Juros
CartaoCreditoParcEstab=Cartão de Crédito Parcelado Estabelecimento
CartaoCreditoProRata=Cartão de Crédito Pro-Rata
CartaoCreditoParcAdm=Cartão de Crédito Parcelado Administradora
CartaoCreditoDiferido=Cartão de Crédito Diferido
CartaoDebitoAVista=Cartão de Débito à Vista
CartaoDebitoCDC=Cartão de Débito CDC
CartaoCreditoCDC=Cartão de Crédito CDC
CartaoDebitoPreDatado=Cartão de Débito Pré-datado
TEF=T.E.F.
Outro=Outro
GarantiaChequeTecban=Consulta/Garantia Cheque Tecban
GarantiaChequeGenerica=Consulta/Garantia Cheque Genérica
CartaoDebitoParcelado=Cartão de Débito Parcelado
ConsultaAVSCredito=Consulta AVS com Cartão de Crédito
PreAutorizacaoCredito=Pré-autorização com Cartão de Crédito
CancelamentoPreAutorizacao=Cancelamento de Pré-autorização com Cartão de Crédito
ValeRefeicao=Vale Refeição
CartaoNaoBonus=Cartão não Bônus
CartaoNaoPresente=Cartão não Presente
PalavraConectando=Conectando
PalavraConectado=Conectado
PalavraSitef=SiTef
ValorVale=Valor do Vale
CartaoComSenha=Cartão c/senha ?
ValorVenda=Valor da Venda
TaxaAbertura=Taxa de Abertura
PDataPrimeiraParcela=Data da Primeira Parcela
ParcelasDe=parcelas de
UtilizaSaldoDisponivel=Utiliza Saldo Disp?
CampoRestricoesInvalido=Campo Restrições inválido
CampoConfigEspecialInvalido=Campo Configuração Especial inválido
CampoConfirParamAuraInvalido=Campo Parâmetros Aura inválido
CampoTransHabInvalido=Campo Transações Habilitadas padrão inválido
PalavraTotal=Total
ValorEmDinheiro=Valor em Dinheiro
PalavraTroco=Troco
PalavraEm=em
OperadorDiferente=Operador diferente de quem abriu
PalavraContinua=Continua
DataVencimento=Data de Vencimento
FormatoData=DDMMAAAA
ValorPagamentos=Valor dos pagamentos
AtingiuLimitePagamentos=Atingiu qtde máxima de pgtos
DigiteQqTeclaEfetuarPagamento=Digite uma tecla para efetuar o pgto
PagarOutroBoleto=Deseja pagar mais um boleto
PagamentoMinimo=Pgto. Mínimo
PalavraTaxa=Taxa
FornecaDataPreDatado=Forneça a data do Pré-datado. Enter assume
VendaVista=Vista
VendaPontos=Pontos
VendaCupons=Cupons
Kilometragem=Kilometragem do veículo
QtdeLitros=Quantidade de litros
MatriculaMotorista=Matrícula do motorista
PlacaVeiculo=Placa do veículo
KilometragemInvalida=Kilometragem inválida
QtdeLitrosInvalida=Quantidade de litros inválida
DataReceitaMedica=Forneça a data da receita medica (DDMMAAAA)
IndiceMedicamento=Índice do medicamento
MensagemMedicamentoAutorizado=Operação realizada para o produto
MensagemMedicamentoParcialmenteAutorizado=Operação parcialmente realizada para o produto
MensagemMedicamentoNaoAutorizado=Operação não realizada para o produto
MensagemCodigoResposta=Código resposta
CodigoMedicamento=Código do medicamento
ConfirmaCancelamentoMedicamentos=Deseja cancelar medicamentos?
QtdeSolicitada=Quantidade solicitada
PrecoVendaConsumidor=Preço de venda ao consumidor
QtdeDiariaPrescrita=Quantidade diária prescrita
QtdeDevolvida=Quantidade a ser devolvida
NumCupomFiscalOrig=Número do cupom fiscal original
RedeInvalida=Rede Inválida
RedeNaoPermitida=Rede Não Permitida
TipoConsulta=Tipo Consulta
MotivoCancelamento=Motivo Cancelamento
CampoObrigatorio=Campo Obrigatório
TesteComunicacaoRedecard=Confirma o teste de comunicação com a Redecard
AguardeEnvioEstatistica=Aguarde, enviando estatística...
EnvioDadosEstatisticosRedecard=Confirma o envio dos dados estatísticos para a Redecard
EnvioDadosOsRedecard=Confirma a baixa de OS Redecard
MenuAdministrativasRedecard=Funções Administrativas Redecard
AdministrativasRedecard=Selecione a opção desejada
OpcaoTesteComunicacaoRedecard=Teste de comunicação com a Redecard
OpcaoBaixaOsRedecard=Baixa de OS
OpcaoEnvioEstatisticaRedecard=Envio de dados estatísticos
NumeroOs=Número da OS
IdTecnico=Identificação do Técnico
CodOcorrencia=Código da Ocorrência
EpsCredenciada=EPS e Credenciada
EmprPreAprov=Empréstimo Pré-aprovado
ValorEmprPreAprov=Valor do empréstimo
MenuCodigoLimite=Escolha o nome do limite
Simulacao=Simulação
SimulacaoOutroNumParc=Deseja fazer simulação com outro número de parcelas?
EfetivaOperacao=Deseja efetivar operação?
MenuNumContrato=Escolha o número do contrato
ColherAssinaturaContrato=Colher assinatura no contrato
EmprConsignado=Empréstimo Consignado
AberturaConta=Abertura de Conta
ModalidadeConta=Selecione a modalidade da conta
ContaIndividual=Conta Individual
ContaConjuntaEOu=Conta Conjunta E/Ou
ContaConjuntaE=Conta Conjunta E (Solidaria)
QtdeTitulares=Forneça a quantidade de titulares (1 a 3)
QtdeTitularesInvalida=Quantidade de titulares inválida
NumeroCnpj=Forneça o número do CNPJ
DataAberturaEmpresa=Data de Abertura da Empresa
NumeroCpfT1=CPF do Primeiro Titular
DataNascimentoT1=Data de Nascimento do Primeiro Titular
NumeroCpfT2=CPF do Segundo Titular
DataNascimentoT2=Data de Nascimento do Segundo Titular
NumeroCpfT3=CPF do Terceiro Titular
DataNascimentoT3=Data de Nascimento do Terceiro Titular
CepInvalido=CEP Inválido
NomeT1=Nome do Primeiro Titular
NomeT2=Nome do Segundo Titular
NomeT3=Nome do Terceiro Titular
EnderecoComplemento=Complemento
EnderecoCidade=Cidade
EnderecoEstado=Estado
SolicitaSenhaOutrosServicos=Solicite a digitação da senha da Internet (4 dígitos)
SolicitaSenhaOutrosServicosVisorCliente=Digite a senha da Internet (4 dígitos)
SolicitaSenhaT1=Solicite a digitação da senha do Titular 1 (6 dígitos)
SolicitaSenhaT2=Solicite a digitação da senha do Titular 2 (6 dígitos)
SolicitaSenhaT3=Solicite a digitação da senha do Titular 3 (6 dígitos)
SolicitaSenhaT1VisorCliente=Digite a senha do Titular 1 (6 dígitos)
SolicitaSenhaT2VisorCliente=Digite a senha do Titular 2 (6 dígitos)
SolicitaSenhaT3VisorCliente=Digite a senha do Titular 3 (6 dígitos)
EnderecoTitular=Endereço
SenhasNaoCoincidem=Senhas Não Coincidem
SolicitaRedigSenhaOutrosServicos=Solicite a redigitação da senha de 4 dígitos
SolicitaRedigSenhaOutrosServVisorCliente=Digite novamente a senha de 4 dígitos
SolicitaRedigSenhaT1=Solicite a redigitação da senha de 6 dígitos do Titular 1
SolicitaRedigSenhaT2=Solicite a redigitação da senha de 6 dígitos do Titular 2
SolicitaRedigSenhaT3=Solicite a redigitação da senha de 6 dígitos do Titular 3
SolicitaRedigSenhaT1VisorCliente=Digite novamente a senha do Titular 1
SolicitaRedigSenhaT2VisorCliente=Digite novamente a senha do Titular 2
SolicitaRedigSenhaT3VisorCliente=Digite novamente a senha do Titular 3
PagamentoUseCred=Pagamento Cartão UseCred
PagamentoSisCred=Pagamento Cartão SisCred
CancelamentoPagamentoUseCred=Cancelamento de Pagamento Cartão UseCred
CancelamentoPagamentoSisCred=Cancelamento de Pagamento Cartão SisCred
ColetaValorEmprPreAprov=Valor do empréstimo
ColetaDataPrimeiraParcela=Data da primeira parcela (DDMMAAAA)
PNumeroParcelas=Número de parcelas
LimiteDisponivel=Limite Disponível
QtdeMaximaParcelas=Max. Parcelas
VectoPrimeiraParcela=Vecto da Primeira Parcela
EmprestimoPessoal=Empréstimo Pessoal
ValorMinimoParcela=Parcela Mínima
PagamentoEMS=Pagamento de Parcelas EMS
CancelamentoPagamentoEMS=Cancelamento do Pagamento de Parcelas EMS
TipoDocumentoEMS=Selecione o tipo do documento EMS
CodigoResumidoEMS=Código Resumido
CodigoBarrasCarne=Código de Barras do Carne
CarneDigitado=Digitação dos Dados do Carne
MenuConsultasEMS=Consultas EMS
TipoConsultaEMS=Selecione o Tipo de Consulta EMS
ConsultaRapidaEMS=Consulta de parcela para pagamento
ConsultaExtratoEMS=Consulta Extrato
ConsultaMilhasEMS=Consulta Milhas
ConsultaMiniExtratoEMS=Consulta Mini Extrato
ConsultaComposicaoFaturaEMS=Consulta Composição de Fatura
RegistraOcorrenciaEMS=Registro de Ocorrência
RegistraCancOcorrenciaEMS=Registro de Cancelamento de Ocorrência
InclusaoClienteEMS=Cadastro de Cliente - INCLUSAO
AlteracaoClienteEMS=Cadastro de Cliente - ALTERACAO
ConsultaDadosCadastraisEMS=Informações Cadastrais do Cliente
TipoEntradaEMS=Selecione o tipo de entrada
EscopoExtratoEMS=Selecione o tipo de escopo do extrato
EscopoParcial=Parcial
EscopoTotal=Total
Loja=Código da Loja
Pdv=Código do PDV
Nome=Nome
NomeMae=Nome da Mãe
DddTelefoneResidencial=DDD do telefone residencial
TelefoneResidencial=Telefone Residencial
RamalTelefoneResidencial=Ramal do telefone residencial
DddTelefoneComercial=DDD do telefone comercial
TelefoneComercial=Telefone Comercial
RamalTelefoneComercial=Ramal do telefone comercial
OrgaoExpedidorRg=Órgão expedidor do RG
UfRg=Estado onde foi inscrito o RG
DataExpedicaoRg=Data de Emissão do RG (DDMMAAAA)
Sexo=Selecione o sexo da pessoa
SexoMasculino=Masculino
SexoFeminino=Feminino
MatriculaOperador=Matrícula do Operador
MatriculaConferente=Matrícula do Conferente
MenuTransacoesEMS=EMS
TipoTransacaoEMS=Selecione o tipo de venda
VendaCartaoEMS=Venda Cartão EMS
VendaOutrosMeiosEMS=Venda Outros Meios
ValorMilhas=Valor das milhas utilizadas
ValorVista=Valor à vista
TaxaJuros=Percentual de Juros do Financiamento
TipoPagamentoEMS=Selecione a forma de pagamento
EMSVista=À Vista
EMSParceladoSemJuros=Parcelado Sem Juros
EMSParceladoComJuros=Parcelado Com Juros
MatriculaAutorizador=Matrícula do autorizador
TipoVendaEMS=Selecione o Tipo de Venda
VendaNormalEMS=Normal
VendaForcadaEMS=Forcada
TipoOcorrenciaEMS=Selecione o Id da Ocorrência
EMSListaPresentes=Compra vinculada a lista de presentes
EMSDemaisCasos=Todos demais casos
TipoPrincipalPagamentoEMS=Selecione a forma principal de pagamento
EMSNaoInformada=Não informada
EMSDinheiro=Dinheiro
EMSChequeVista=Cheque à Vista
EMSChequePre=Cheque Pré
EMSCartaoDebito=Cartão de Débito
EMSCartaoCredito=Cartão de Crédito
EMSTicket=Ticket
EMSChequeAdm=Cheque Administrativo
EMSTravellerCheck=Traveller Check
EMSDescontoFolha=Desconto em Folha
EMSVale=Vale
EMSMilhas=Milhas
DataCupomFiscalOrig=Data do cupom fiscal original
HoraCupomFiscalOrig=Hora do cupom fiscal original (HHMMSS)
CancelamentoTransacoesEMS=Cancelamento EMS
TipoConvenioEMS=Tipo de convenio EMS
EMSVoucher=Pré-Pago Voucher
EMSCartaoPresente=Pré-Pago Cartão-Presente
EMSPrivateLabel=Private Label
EMSTipoCodigoExterno=Tipo de código externo
EMSCodigoExterno=Código externo
EMSCartao=Cartão
ProvedorAutorizacaoGenericaEMS=Autorização Genérica EMS
AcumulaMilhas=Acumula milhas?
CodigoConsulta=Código consulta
CancAutorizacaoGenerica=Cancelamento autorização genérica EMS
CodMilhasDiferenciadas1=Primeiro código de milhas diferenciadas
ValorMilhasDiferenciadas1=Primeiro valor de milhas diferenciadas
CodMilhasDiferenciadas2=Segundo código de milhas diferenciadas
ValorMilhasDiferenciadas2=Segundo valor de milhas diferenciadas
CartaoParceleMais=Parcele Mais Redecard
MenuDiasEntreParcelas=Selecione o número de dias entre as parcelas
ValorParcelas=Valor das parcelas
TipoProduto=Selecione o produto
CartaoOmnion=Cartão Omnion
CancelamentoCartaoQualicard=Cancelamento de Cartão Qualicard
CancelamentoCartaoOmnion=Cancelamento de Cartão Omnion
SaldoOmnion=Consulta Saldo Omnion
DDDInvalido=DDD Inválido
TelefoneInvalido=Telefone Inválido
HoraInvalida=Hora Inválida
ObtendoRegistro=OBTENDO REGISTRO
PagamentoCondor=Pagamento Condor
EstoronPagamentoCondor=Cancelamento pagamento Condor
ConsultaCondor=Consulta Condor
CartaoNovo=Cartão novo?
SolicitaRedigSenha=Redigite a nova senha
SolicitaRedigSenhaVisorCliente=Redigite a nova senha
ParceleMais=Parcele Mais
CancelamentoParceleMais=Cancelamento Parcele Mais
CartaoStarfiche=Starfiche
CancelamentoCartaoStarfiche=Cancelamento Starfiche
TipoPagamentoCartaoFininvest=VENDA CARTAO PRIVATE LABEL
PagamentoFaturaFininvest=Pagamento de fatura Fininvest
ConsultaCartaoFininvest=Consulta Private Label
TituloSaqueFininvest=SAQUE CARTAO FININVEST
ConsultaSaqueFininvest=Consulta saque e saque Fininvest
CancelamentoFininvest=Cancelamento Venda Private Label
CancelamentoSaqueFininvest=Cancelamento Saque Fininvest
EstornoRecebimentoFininvest=Estorno de Pagamento Fininvest
RecebimentoFininvest=Pagamento de Conta Fininvest
SaqueRotativoFininvest=Saque Rotativo Private Label
SaqueParceladoFininvest=Saque Parcelado Private Label
ConsultaSaqueRotativoFininvest=Consulta Saque Rotativo Private Label
ConsultaSaqueParceladoFininvest=Consulta Saque Parcelado Private Label
ConsultaVendaParceladaFininvest=Consulta Venda Parcelada Private Label
ConsultaVendaPreDatadaFininvest=Consulta Venda Pré-datada Private Label
CancelamentoCartaoFininvest=Cancelamento de Cartão Private Label
NumeroInvalido=Número Inválido
NumeroPedido=Número do Pedido
ProdutoInvalido=Produto inválido
ExcedeuQtdeProdutos=Excedeu quantidade de produtos
PagamentoUpSight=Pagamento UpSight
CancelamentoPagamentoUpSight=Cancelamento de Pagamento UpSight
AprovacaoSaldoParcial=Confirma Pagamento Parcial
AprovacaoSomenteCompra=Confirma Aprovação Somente do Valor da Compra
AprovacaoSaqueParcial=Confirma Saque Parcial
Saque=Saque
ColetaSenhaAutorizadorPP=Digite a senha do autorizador Pinpad
ContaPJ=Pessoa Jurídica
TrocaSenhaAutorizadorPP=Troca de senha do autorizador Pinpad
NovaSenhaAutorizadorPP=Digite a nova senha
NovaSenhaAutorizadorPPRedig=Redigite a nova senha
ColetaSenhaAutorizadorPPDI= DIGITE A SENHA    AUT.PINPAD
NovaSenhaAutorizadorPPDI= DIGITE A NOVA  SENHA AUT.PINPAD
NovaSenhaAutorizadorPPRedigDI=REDIGITE A NOVA SENHA AUT.PINPAD
CodigoAutorizadorPP=Código do autorizador do Pinpad
TipoCDCCredito=Tipo CDC Crédito
PayPass=PayPass
AproximeCartaoLeitora=Aproxime o cartão da leitora
PagamentoRedeMAR=Pagamento Rede MAR
CancelamentoPagamentoRedeMAR=Cancelamento de Pagamento Rede MAR
PagamentoICards=Pagamento iCards
CancelamentoPagamentoICards=Cancelamento de Pagamento iCards
PagamentoQualicard=Pagamento Qualicard
CancelamentoPagamentoQualicard=Cancelamento de Pagamento Qualicard
ErroFuncionalidadeNaoPermitida=Funcionalidade não permitida para esta transação
DadosFormaPagamento=Dados da forma de pagamento
PasseAproximeCartaoLeitora=Insira ou passe ou aproxime o cartão na leitora
DIErroAcessoArquivo=Erro de acesso a arquivos
ColetaCartaoTerceiro=Cartão de terceiro
ErroChangeParameters=Erro Troca de Parâmetros Tabela PinPad
AjusteDebito=Ajuste de Cartão de Débito
AjusteCredito=Ajuste de Cartão de Crédito
ValorFinanciamento=Valor financiamento
CancelamentoPagamentoFatura=Cancelamento Pagamento de Fatura
CancelamentoGarantiaChequeTecban=Cancelamento Garantia de Cheque Tecban
CancelamentoGarantiaChequeGenerica=Cancelamento Garantia de Cheque
ServTemporariamenteIndisp=Serviço Temporariamente Indisponível
CompraComPontos=Compra com Pontos
PagamentoOboe=Pagamento Cartão Oboe
PagamentoAVista=Pagamento Cartão ÀVista
AcumuloPontosOboe=Acumulo de Pontos Oboe
CancelamentoAcumuloPontosOboe=Cancelamento de Acumulo de Pontos Oboe
TerminalOriginal=Código do Terminal Original
RedeDestino=Rede de Destino
IdentificacaoCliente=Identificação do Cliente
CodigoBarras=Código de Barras
CreditoPlano=Parcelado com Plano
CreditoAutorizacaoVista=Com Autorização
CreditoAutorizacaoPlano=Com Autorização Parcelada com Plano
CreditoBoleto=Boleto
DocumentoVendaBoleto=Nsu da Venda Boleto
Motivo=Motivo
CartaoQualidade=Cartão Qualidade
InsiraCartao=Insira o cartão
NumPdvOrig=Número do Pdv original
MenuOperadora=Selecione a Operadora de Serviços
MenuDependente=Selecione o Dependente
TipoEntrada=Selecione o Tipo de Entrada
TipoEmbalagem=Tipo de Embalagem
PrecoBruto=Preço Bruto
PrecoLiquido=Preço Líquido
ValorReceberDaLoja=Valor a receber da Loja
PercentualDesconto=Percentual de Desconto
ValorLiquido=Valor Líquido
CodigoMedicamentoEAN=Código do medicamento (EAN)
PagueFacil=Pague-Fácil
MenuConvenio=Selecione o Convênio
TamanhoInvalido=Tamanho inválido
ConsultaSegmentoPagueFacil=Pague-Fácil Segmento
UfPagueFacil=Pague-Fácil UF
EmpresaPagueFacil=Pague-Fácil Empresa
ProdutoPagueFacil=Pague-Fácil Produto
EntradaPagueFacil=Pague-Fácil Parametro Entrada
DadosSequenciaPagueFacil=Pague-Fácil Conteudo Entrada
DadosBiDigSequenciaPagueFacil=Pague-Fácil Bi-Digitação Conteúdo Entrada
ValoresPagueFacil=Pague-Fácil Valor
ModuloInvalido=Módulo Inválido
NumeroChequeEntrada=Número do cheque de entrada
PalavraParcela=Parcela
ConfirmaEmbosso=Embosso <EMBOSSO/> correto?
InputStartGoOnChip=Dados StartGoOnChip
TagsStartGoOnChip=Tags obrigatórias StartGoOnChip
TagsOpcStartGoOnChip=Tags opcionais StartGoOnChip
InputFinishChip=Dados FinishChip
TagsFinishChip=Tags FinishChip
ErroArqTabPinPad=Nome Arquivo Tabelas PinPad não encontrado
ErroProcArqTabPinPad=Erro processando Arquivo Tabelas PinPad
Bit55FinishChip=Bit55 FinishChip
CartaoVirtualFormosa=Cartão Virtual Formosa
PagamentoCartaoNeus=Pagamento cartão Neus
EstornoPagamentoCartaoNeus=Estorno pagamento cartão Neus
PagamentoCartaoFoxWinCards=Pagamento cartão FoxWin Cards
EstornoPagamentoCartaoFoxWinCards=Estorno pagamento cartão FoxWin Cards
CampoFormatoInvalido=Campo com formato inválido
ValorSubsidiado=Valor Subsidiado
AtingiuLimiteProdutos=Atingiu qtde máxima de produtos
PagamentoAlgorix=Pagamento Cartão Algorix
CancelamentoPagamentoAlgorix=Cancelamento de Pagamento Algorix
CargaCartaoPresenteAlgorix=Carga Cartão Presente Algorix
CancelamentoCargaCartaoPresenteAlgorix=Cancelamento Carga Cartão Presente Algorix
ValorTaxa=Valor da Taxa
CartaoCompreMax=Cartão CompreMax
CancelamentoCartaoCompreMax=Cancelamento de Cartão CompreMax
TipoCartaoCombustivel=Selecione o tipo do Cartão de Combustível
CancelamentoCartaoCombustivel=Cancelamento de Cartão de Combustível
DigitacaoPinPad=Solicite digitação do cliente no PinPad
CodigoServico=Código do serviço
ValorServico=Valor do serviço
TipoVenda=Tipo de Venda
InsiraCartaoLeitora=Insira o cartão na leitora
PagamentoSysdata=Pagamento Private Label Sysdata
CancelamentoPagamentoSysdata=Cancelamento de Pagamento Private Label Sysdata
FormaPagamentoSysdata=Forma de pagamento (1:Dinheiro, 2:Cheque)
TipoDocumentoValidata=Tipo do documento
TipoDocumentoNossoNumeroValidata=Nosso Número
CodAreaCheque=DDD da Cidade do Cheque
CRMCRO=Forneça o documento (CRM ou CRO)
TipoMedicamento=Tipo de medicamento
PrecoFuncionalCard=Preço Funcional Card
QuantidadeReceitada=Quantidade receitada
QuantidadeVendida=Quantidade vendida
TipoDocumentoPBM=Tipo do documento (0: CRM, 1: CRO)
PalavraReferencia=Referencia
ValorTotalProduto=Valor total produto
QuantidadeInvalida=Quantidade inválida
Publishers=Publishers
SelecioneValor=Selecione o valor
ConfirmaVenda=Confirma venda?
MenuPinJogos=Pin de Jogos
MenuPinRecarga=Outros
MenuPinRecargaGerencial=Pin Outros
PPDigiteNovaSenha=DIGITE          NOVA SENHA
DIDigiteNovaSenha=DIGITE A NOVA SENHA
PPRedigiteNovaSenha=REDIGITE        NOVA SENHA
DIRedigiteNovaSenha=REDIGITE A NOVA SENHA
PPDigiteSenhaTemporaria=DIGITE          SENHA TEMPORARIA
DIDigiteSenhaTemporaria=DIGITE A SENHA TEMPORARIA
PPSenhaAtual=SENHA ATUAL
EfetuaPagamento=Efetua Pagamento?
TransacaoAprovadaCartaoBandeira=TRANSACAO APROVADA
TransacaoNegadaCartaoBandeira=TRANSACAO NEGADA CHIP
PagamentoRedeSQCF=Pagamento Cartão Fidelidade Qualita
CancelamentoPagamentoSQCF=Cancelamento Pagamento Cartão Fidelidade Qualita
NumeroIdFatura=Número de identificação da fatura
DITrnAceita=Transação aceita, Retire o Cartão
PPTrnAceita=TRANSACAO ACEITA
PPTrnNaoAceita= TRANSACAO NAO\r     ACEITA
NumeroCpfCnpj=Forneça o número do CPF ou CNPJ
CpfCgcProprietario=Forneça o número do documento do Proprietário
ForcaAprovacaoTransacao=Forca Aprovação da Transação?
CpfPortador=Forneça o número do CPF do Portador
TipoDocumentoProprietario=Tipo do documento do Proprietário (0: CPF, 1: CNPJ)
CpfProprietarioPortador=Forneça o CPF - Proprietário/Portador
CpfProprietario=Forneça o número do CPF do Proprietário
CnpjProprietario=Forneça o número do CNPJ do Proprietário
CpfFavorecidoPortador=Forneça o CPF - Favorecido/Portador
CpfFavorecido=Forneça o número do CPF do Favorecido
CnpjFavorecido=Forneça o número do CNPJ do Favorecido
NumeroCheques=Escolha o talonário
FornecaDataPrimeiraParcela=Forneça a data da Primeira Parcela. Enter assume
PalavraQuantidade=Quantidade
SaqueGetNet=Saque GetNet
SaqueVista=À Vista
CancelamentoSaqueGetNet=Cancelamento Saque GetNet
MenuFornecedoresVoucher=Selecione o fornecedor
ConsultaFornecedores=Consulta de Fornecedores
ResgatePontos=Resgate de Pontos
ConsultaProdutos=Consulta de Produtos
ValorVoucher=Valor do Produto
IncluirProduto=Incluir outro produto?
ValorTransferenciaCB=Valor da transferência
Min=Min
Max=Max
Sugerido=enter
EmissaoPontos=Emissão de Pontos
CancelamentoEmissaoPontos=Cancelamento de Emissão de Pontos
TipoCartaoFidelidade=Cartão Fidelidade
NumeroPontosResgatar=Número de pontos a resgatar
NumeroPontosCancelar=Número de pontos a cancelar
TipoContaDebito=Selecione o tipo da conta a ser debitada
TipoContaCredito=Selecione o tipo da conta a ser creditada
TransferenciaContas=Transferência entre contas
PPSenhaInternet=Senha Internet  4 Digitos
PPConfirmeSenhaInternet=Confirme Senha  Internet
PPSenhaTitular=Senha Titular %01d 6 Digitos
PPConfirmeSenhaTitular=Confirme Senha  Titular %01d
RevalidacaoSenhaINSS=Revalidação Senha Cartão INSS
CreditoParcAdmSemEntrada=Parcelado pela Administradora sem entrada
CreditoEstabAdmSemEntrada=Parcelado pelo Estabelecimento sem entrada
Transferência=Transferência
ValorTransferencia=Forneça o valor da Transferência
CancelamentoTransferencia=Cancelamento Transferência
CodigoCliente=Código do cliente
TipoRecarga=Tipo de Recarga
PPChipInsiraCartao=CARTAO COM CHIP\rINSIRA O CARTAO
ModalidadeDepositoIdentificado=Modalidade Depósito (Opção de ESTORNO não Permitida)
PagamentoTricard=Pagamento de fatura Tricard
CodigoDepositante=Código Depositante
CartaoPagamento=Cartão Pagamento
CodigoClienteCB=Código Cliente
SequenciaCartao=Sequencia Cartão
ViaCartao=Via Cartão
ConfValorTotal=Confirma Valor Total ?
ConfChequesRestricao=Cheque(s) com Restrição :
DesejaContinuar=Deseja Continuar ?
SoChip=Somente cartões com chip são aceitos
SoCartaoMag=Somente cartões magnéticos são aceitos
CancelamentoDebitoRepom=Cancelamento de Débito REPOM
ErroAssinaturaModulos=Erro Assinatura dos Módulos
PreAutorizacaoCombustivel=Pré-autorização Combustível
CpfCnpjFormatada=CPF ou CNPJ
NaoMagneticoCodigoBarrasFidelize=Leitura via código de barras Fidelize
MagneticoChip=Magnético/Chip
DigiteSenhaOperador=Digite a senha do Operador
ConsultaTabelasCelular=Consulta de Tabela de Celular
SenhaNaoCadastrada=Senha Não Cadastrada
FuncoesGerenciaisRecarga=Funções Gerenciais Recarga
PalavraRecarga=Recarga
TabelaCelular=Tabela de Celular
DigiteNovaSenhaOperador= Digite a nova senha do Operador
ImpressaoRelatorio=Relatório de Recarga
CadastraNovaSenha=Cadastro de Senha
RedigiteNovaSenhaOperador= Redigite a nova senha do Operador
ConsultaConcessionarias=Consulta de Operadoras
SemTrnDisponiveis=Sem Transações
TrocaNovaSenha=Alteração de Senha
MenuDataRelatorio=Escolha a Data
ColetaDadosBacen=Dados do Portador e Proprietário
ValorDevolucao=Forneça o valor da transação a ser devolvida
ContaEspecial=Especial
ContaFidelidade=Fidelidade
OutraConta=Outra Conta
PosicaoDaConta=Posição da Conta
PosicaoDaContaInvalido=Posição da Conta Inválido
MeioDePagamento=Meio de Pagamento
TextoOutros=Outros
TextoProvincial=Provincial
CodigoAtendente=Forneça o código do atendente
PorcentualDesconto=Forneça o porcentual de desconto
FechamentoLotePlatco=Fechamento de lote - Platco
RegistroGorjeta=Registro de Gorjeta
ValorGorjeta=Forneça o valor da gorjeta
ValorTrnOriginal=Forneça o valor da transação original
DocumentoTrnOriginal=Forneça o número do documento da transação original
ConsultaUltimaVenda=Consulta última venda
GarantiaChequePlatco=Garantia cheque Platco
DevolucaoPlatco=Devolução - Platco
CargaForcadaPlatco=Carga forcada - Platco
SupervisorInvalido=Supervisor inválido
Continue=Continue
ColetaDadosBacenSaqueComCheque=Dados do Favorecido e Portador
VendedorPbm=Vendedor
SenhaPBM=Senha
NumeroVoucher=Número do voucher
PalavraCred=Credit
PalavraDeb=Debit
TipoCriptografiaNaoSuportado=Tipo de criptografia não suportado
ValorConsulta=Forneça o valor a ser consultado
ConsultaParcelasCredito=Consulta parcelas crédito
SaldoGift=Consulta Saldo Gift
TipoCartaoGift=Selecione uma opção
MenuCancGift=Menu Cancelamento Gift
ValorRecargaCartaoGift=Valor a ser recarregado
RecargaGift=Recarga Gift
CartaoGift=Cartão Gift
CancelamentoRecargaCartaoGift=Cancelamento Recarga Gift
CancelamentoCartaoGift=Cancelamento Cartão Gift
CancelamentoCartaoEletrozema=Cancelamento Cartão Eletrozema
MenuAdmGift=Menu Administrativo Gift
MenuConsultasEletrozema=Consulta Eletrozema
MenuAtivacaoGift=Ativacao Gift
OpcaoInjecaoChavesDukptRedecard=Injeção de chaves dukpt Redecard
ConfirmaInjecaoChavesDukptRedecard=Confirma a injeção de chaves dukpt Redecard
ErroInjecaoChavesDukptRedecard=Erro na injeção de chaves dukpt
InjecaoChavesDukptRedecardOK=Injecao de chaves.Trans.completada.
ChavesDukptRedecardJaCarregadas=Erro.Chaves dukpt já carregadas.
PagamentoFaturaGenerico=Pagamento de Fatura
ColetaPinPad=Solicite a digitação no pinpad
ConsultaNegada=Cartão gift não aceito
Fim=Finalizar leitura e ir para pagamento
Subtotal=Subtotal
DISenhaBloqueadaRetireCartao=Senha Bloqueada. Retire o Cartão
PPSenhaBloqueada=     SENHA\r   BLOQUEADA
SelecioneGratificacaoSAV=SELECIONE GRATIFICACAO
SelecioneFuncaoSAV=SELECIONE FUNCAO
EmissaoIngressoSAV=EMISSAO DE INGRESSO
AutorizacaoIngressoSAV=AUTORIZACAO DE INGRESSO
ConfirmaGratuidade=CONFIRMA GRATUIDADE?
DataEntrada=Data de entrada do veículo
DataSaida=Data de saída do veículo
HoraEntrada=Hora de entrada do veículo
HoraSaida=Hora de saída do veículo
TipoClienteEstacionamento=Tipo de Cliente (1: Rotativo; 2: Mensalista)
ValorDesconto=Valor do desconto
Sucursal=Sucursal
NumeroApolice=Número da Apólice
NumeroItem=Número do Item
PinCode=PinCode
AidInvalido=AID inválido
PPErroComunicSegura=ERRO DE LEITURA\rTENTE NOVAMENTE
DIErroComunicSegura=Erro de leitura, tente novamente.
PagamentoRedeCitibank=Pagamento Cartão Citibank
TipoDocumentoPagamentoFatura=Tipo do documento
TipoDocumentoNossoNumero=Nosso Número
ContratacaoRaizen=Contratação Cartão Shell
PrimeiraCompraRaizen=Primeira Compra Cartão Shell
ConsultaFrentistaRaizen=Consulta Frentista Shell
MenuCancPrimeiraCompraRaizen=Cancelamento Primeira Compra Cartão Shell
ReimpressaoEspecificaContratacaoRaizen=Contratação Cartão Shell
MenuTipoCartaoRegistroRaizen=Selecione uma opção
CodigoFrentista=Código do Frentista
ConfirmeOpcaoSelecionada=Confirme a opção selecionada:
ConsultaPontosCuponsVenezuela=Consulta pontos ou cupons Venezuela
ConsultaPontosVenezuela=Consulta pontos
ConsultaCuponsVenezuela=Consulta cupons
ContaFal=Fal
ContaPrincipal=Principal
ConsultaExtraFinanConsorcioVenezuela=Consulta Extra Financiamento - Consorcio Venezuela
PalavraModoInvalido=Modo inválido
FechamentoLote=Fechamento de lote
FechamentoLoteForcado=Fechamento de lote forçado
TipoFechamentoLote=Tipo de fechamento de lote
ErroFechamentoLoteVenezuela=Erro no fechamento de lote
PalavraVenda=Venda
RealizaVendaCreditoDigitada=Deseja realizar venda crédito digitada?
RelatoriosPlatco=Relatórios - Platco
TiposRelatorios=Tipos de relatórios
RelatorioTotais=Relatório de totais
RelatorioDetalhado=Relatório Detalhado
RelatorioResumoGorjetas=Resumo de gorjetas
RelatorioLoteAnterior=Relatório do lote anterior
RelatoriosConsorcio=Relatórios - Consorcio Venezuela
DataResumo=Data (DDMMAAAA)
DtIniRelat=Data de Inicio do Resumo.
HoraIniRelat=Hora de Inicio do Resumo.
DtFimRelat=Data de Termino do Resumo. Enter assume data atual
HoraFimRelat=Hora de Termino do Resumo. Enter assume ate última transação do dia
EnterAssume=Enter assume
ConfDtUltRelat=Utilizar data e hora do último resumo:
InicioHistorico=Enter assume início do histórico
PPErroCtlssMultiple=Erro comunicacao\r  com o cartao
DIErroCtlssMultiple=Erro de comunicação com o cartão
PPErroCtlssCommErr=Erro comunicacao\r  com o cartao
DIErroCtlssCommErr=Erro de comunicação com o cartão
PPErroCtlssInvalidat=Cart. invalidado\r Use Chip/Tarja
DIErroCtlssInvalidat=Cartão invalidado, use Chip/Tarja
PPErroCtlssProblems=Cartao invalido\r Use Chip/Tarja
DIErroCtlssProblems=Cartão inválido, use Chip/Tarja
PPErroCtlssAppNav= Modo invalido\r Use Chip/Tarja
DIErroCtlssAppNav=Modo inválido, use Chip/Tarja
PPErroCtlssAppNaut=   Nao aceito\r Use Chip/Tarja
DIErroCtlssAppNaut=Não aceito, use Chip/Tarja
TelefoneNaoPermitido=Operadora não permite 9 dígitos
LeituraCodigoBarras=Passe o código de barras
CartaoGiftRepetido=Erro na consulta. Cartão já consultado nesta transação.
ValorASerPago=Valor a ser pago
IncluirOutroProduto=Deseja incluir outro produto?
PFormaPagamento=Forma de pagamento
AcumuloPontosDotz=Acumulo de Pontos Dotz
ResgatePontosDotz=Resgate de Pontos Dotz
SaldoPontosDotz=Saldo de Pontos Dotz
ExtratoPontosDotz=Extrato de Pontos Dotz
TipoCartaoClienteDotz=Selecione o tipo do Cartão Cliente Dotz
NaoMagneticoCnpj=Digitado via CNPJ
TipoCartaoAtendenteDotz=Selecione o tipo do Cartão Atendente Dotz
CodigoPromocao=Código da Promoção
QtdeItensPromocao=Quantidade de itens da Promoção
AtingiuLimiteCartoes=Atingiu qtde máxima de cartões
NumeroBog=Fornece o número do BOG
NaoMagneticoCpfGivex=Digitado via CPF Givex
InformeCPFRaizen=Informe o CPF
DISenhaIrmaoCaminhoneiroRaizen=Solicite a digitação da senha
PPSenhaIrmaoCaminhoneiroRaizen=Cadastre a senha
DIRedigSenhaIrmaoCaminhoneiroRaizen=Solicite a redigitação da senha
PPRedigSenhaIrmaoCaminhoneiroRaizen=Confirme a senha
DISenhaVPowerRaizen=Solicite a digitação da senha
PPSenhaVPowerRaizen=Digite a senha
ValorPagamentoRaizen=Digite o valor da venda
PagtoVPowerRaizen=Crédito V-Power
CancPagtoVPowerRaizen=Cancelamento Crédito V-Power
TampaPremiadaRaizen=Incentivo Lubes
ContratIrmaoCaminhoneiroRaizen=Clube Irmao
RegistroVisitasRaizen=Registro de Visitas Clube Irmao
ExtratoVPowerRaizen=Extrato Crédito V-Power
CartaoClubeRaizen=Cartão Clube
RegistroPorCPFRaizen=Registro por CPF
ResumoVendasParcial=Resumo de Vendas Parcial
ResumoVendasTotal=Resumo de Vendas Total
MenuSaqueGift=Saque Gift
MenuCancelamentoSaqueGift=Cancelamento de Saque Gift
ProdutoGiftInvalido=Código de Produto inválido
DigViaCodUnitario=Digitado via Código Unitário
CodigoProdutoEAN=Código do Produto (EAN)
DigiteCodigoUnitario=Digite o Código Unitário
ConfirmaTaxa=Confirma Taxa
ConsultaNaoRealizada=Consulta não realizada
NumeroEGift=Forneça o número do EGift
NaoMagneticoEGift=Digitado EGift
CreditoParcelado=Parcelado
ParceladoAdmin=Financ. Adm.
ParceladoEstab=Financ. Loja
CreditoVista=À Vista
CreditoPreDatado=Pré-Datado
DebitoVista=À Vista
DebitoCDC=Pagamento CDC
DebitoPreDatado=Pré-Datado
Magnetico=Magnético ou CHIP
NaoMagnetico=Digitado
NovoValor=Forneça o novo valor do pagamento
Embosso=Forneça os 4 dígitos finais do cartão
NumeroParcelas=Forneça o número de parcelas
TaxaEmbarque=Forneça a taxa de embarque
TaxaServico=Forneça a taxa de serviço
MenuInicial=Selecione Cartão
ValorPrimeiraParcela=Valor 1a Parc.?
DocumentoCancelamento=Número do Doc
CodigoSeguranca=Forneça o Código de Segurança do cartão (0: inexistente, 1: ilegível)
TipoPagamentoCartaoCredito=Selecione a forma de pagamento
ValorEntrada=Forneça o valor da entrada
DataPrimeiraParcela=Forneça a data da primeira parcela (DDMMAAAA)
TipoGarantia=Pré-datado 1-Com Garantia, 2-Sem Garantia
TipoPagamentoCartaoDebito=Selecione a forma de pagamento
DataPreDatado=Forneça a data do Pré-datado (DDMMAAAA)
CodigoAutorizacao=Forneça o código de autorização
DataTransacao=Data da transação (ddmmaaaa)
ValorCancelamento=Valor do cancelamento
TransacaoInvalida=Transação Inválida
CartaoInvalido=Cartão inválido
CodigoSegurancaInvalido=Código Segurança Inválido
TrnNaohabilitada=Transação não habilitada
SolicitaSenha=Aguarde a Senha
SolicitaSenhaVisorCliente=Digite a senha
PPConfirmacaoPinPad=CANCEL     ENTER
DIConfirmacaoPinPad=Solicite confirmação do cliente no PinPad
RetireCartao=Retire o cartão da leitora
TrnNaoLocalizada=Transação não localizada no Log. Continua?
ValorTrn=Digite o valor da transação
CampoInvalido=Dados inválidos
Endereco=Endereço da fatura do cartão
EnderecoNumero=Número
EnderecoAndar=Andar
EnderecoConjunto=Apto/Conjunto
EnderecoBloco=Bloco
EnderecoCep=Cep
EnderecoBairro=Bairro
Cpf=Cpf
TipoCartaoCredito=Selecione o tipo do Cartão de Crédito
TipoCartaoDebito=Selecione o tipo do Cartão de Débito
NumeroCartao=Forneça o número do cartão
DataValidadeCartao=Forneça a data de vencimento do cartão (MMAA)
MenuOutros=Outros Cielo
Documento=Documento a ser pago
DataInvalida=Data inválida
PPCartaoVencido=     Cartao\r    Vencido
DICartaoVencido=Cartão Vencido
PPDataVencimentoInvalida=Data Vencimento\r    Invalida
DIDataVencimentoInvalida=Data Vencimento Inválida
PPCartaoInvalido=     Cartao\r    Invalido
DICartaoInvalido=Cartão Inválido
ChipInsiraCartao=Cartão com chip. Insira o cartão
ChipModoInvalido=Cartão com chip. Modo inválido
LeitorChipInativo=Leitor inativo. Passe o cartão
OperacaoNaoPermitida=Operação não permitida
DigitacaoNaoPermitida=Digitação não permitida
NumParcelasInvalido=Número de Parcelas Inválido
ExcedeParcelas=Excede Parcelas
ValorMinParcelaInvalido=Valor Mínimo da Parcela Inválido
ValorInvalido=Valor Inválido
ValorEntradaMaiorIgual=VL entrada maior igual VL venda
ValorParcelaInvalido=Valor da Parcela Inválido
ExcedePrazo=Excede Prazo
ExcedeTaxa=Excede Taxa
PPOperacaoCancelada=    Operacao\r    Cancelada
DIOperacaoCancelada=Operação Cancelada
CodAutorizacaoInvalido=Código de Autorização Inválido
DocumentoInvalido=Documento Inválido
GarantiaInvalida=Garantia Inválida
CanceladoCliente=Cancelado pelo Cliente?
PPNaoAutorizadaCartao= Transacao nao\raut. pelo cartao
DINaoAutorizadaCartao=Transação não autorizada pelo cartão
ValoresDiferentes=Valores Não Coincidem
CodigoInvalido=Código Inválido
ConfirmaValor=Confirma valor:
Cartão=CARTAO
Data=DATA
ValorVenda=VALOR VENDA
ValorCancelamentoReduzido=VALOR CANC.
NSU=DOC
ConfirmaCancelamento=Confirma Cancelamento?
BomPara=Bom para
Saque1=VALOR COMPRA&SAQUE
Saque2=SAQUE
CartaoVoucherAVista=Cartão Voucher à Vista
PalavraValor=Valor
CartaoCreditoAVista=Cartão de Crédito à Vista
CartaoCreditoParcEstab=Cartão de Crédito Parcelado Estabelecimento
CartaoCreditoProRata=Cartão de Crédito Pro-Rata
CartaoCreditoParcAdm=Cartão de Crédito Parcelado Administradora
CartaoDebitoAVista=Cartão de Débito à Vista
CartaoDebitoCDC=Cartão de Débito CDC
CartaoDebitoPreDatado=Cartão de Débito Pré-datado
TEF=T.E.F.
CancCartaoDebito=Cancelamento de Cartão de Débito
CancCartaoCredito=Cancelamento de Cartão de Crédito
CartaoPrivateLabelPreDatado=Cartão Private Label Pré-datado
DiasPrimeiraParcela=Dias 1a Parcela
QuantidadeDias=Forneça o número de dias
NumDiasInvalido=Número de Dias Inválido
PagamentoDinheiro=Dinheiro
PagamentoCheque=Cheque
TipoCartaoVisaOutros=Selecione o tipo do cartão
CieloTipoResgate=Selecione o tipo de resgate
CieloValorNaoPodeSerZero=Valor informado não pode ser zero
CieloValorSuperiorQtdDisponivel=Valor informado superior a quantidade disponível
CieloDIConfirmacaoResgatePP=Solicite ao cliente a confirmação do resgate no PinPad
CieloPalavraResgatar=Resgatar
CieloPPResgatePremios=   RESGATE DE\r    PREMIOS
CieloResgateNaoEfetuado=Resgate não efetuado
CieloPPResgateNaoEfetuado=   RESGATE NAO\r    EFETUADO
